{
    "name": "7x7 Diamond",
    "width": 7,
    "height": 7,
    "mask": [
      [0, 0, 0, 1, 0, 0, 0],
      [0, 0, 1, 1, 1, 0, 0],
      [0, 1, 1, 1, 1, 1, 0],
      [1, 1, 1, 1, 1, 1, 1],
      [0, 1, 1, 1, 1, 1, 0],
      [0, 0, 1, 1, 1, 0, 0],
      [0, 0, 0, 1, 0, 0, 0]
    ]
  }